====================
====================
====================
====================
====================
====================
====================
=v=====G============
=.===.=.============
=.....=.============
=.=====.============
=.=====.============
=.=.=.=.============
=.=.=.=.============
=...=.=.============
=.=.=...============
=.=...==============
====================
====================
====================