====================
====================
====================
====================
====================
=........===========
=.==.=.=============
=....=.=============
====.=...===========
=..=..G=.===========
=..=.===^===========
====================
====================
====================
====================
====================
====================
====================
====================
====================