====================
====================
====================
====================
====================
=.......<===========
=.==.===============
=.==...=.===========
=..=.=...===========
==......============
=====.=.G===========
====================
====================
====================
====================
====================
====================
====================
====================
====================