====================
====================
====================
====================
====================
=....=====v=========
=.==.....=.=========
=G====.===.=========
=.=.....==.=========
=.===.====.=========
=..........=========
====================
====================
====================
====================
====================
====================
====================
====================
====================