====================
====================
====================
====================
====================
=........===========
=.==.===============
=..=...=============
==.=.=..G===========
=..=...=============
=^==================
====================
====================
====================
====================
====================
====================
====================
====================
====================